7
7
1 1 1 1 1 1 1
1 5 5 2 2 5 1
1 5 0 5 5 5 1
1 2 2 5 4 2 1
1 2 2 5 5 2 1
1 5 5 5 5 5 1
1 1 1 1 1 1 1
